############
#O         #
#    P  ####
#          #
#### ##    #
#   O ##   #
#     ##   #
#          #
#       XX #
#       #  #
############
